111111111111111111111111111111
1000C0000000000001000010C00001
10C0000001P00E1001000000000001
1C000C0000000110C1000000001001
111111111111111111111111111111