1111111111111
1V010C0C000C1
100C011111V01
1P0V11E000001
1111111111111